
[x] alle md files in space verschieben
[x] Page ins Navigation einf√ºgen
[x] assets bereinigen
[-] auto TOC im Header bereinigen
[x] Footer bereinigen

[ ] Cross-Links bereinigen
[ ] Tabellen bereinigen
[ ] Info und Warnboxen
    
  - Administration: "Administration.md"
    - System: "System.md"
    - Core functions: "Core_functions.md"							
      - REST API: "REST_API.md"
      - Landing pages: "Landing_pages.md"
      - E-Mail Settings: "E-Mail_Settings.md"
      - Files and Folders: "Files_and_Folders.md"
      - WebDAV: "WebDAV.md"
      - Licenses: "Licenses.md"
    - Login: "Login.md"
      - Security: "Security.md"
    - Guest and invitation: "Guest_and_invitation.md"
    - Modules: "Modules.md"
      - Modules Contact Tracing: "Modules_Contact_Tracing.md"
      - Modules Document pool: "Modules_Document_pool.md"
      - Modules Taxonomy: "Modules_Taxonomy.md"
      - Lektionen: "Lecture_and_roll_call_management.md"
      - Modules Organisations: "Modules_Organisations.md"
      - Modules Curriculum: "Modules_Curriculum.md"
      - Instant Messaging: "Instant_Messaging.md"
    - Lebenszyklen : "Life_cycles_-_Administration.md"
      - Automatic Group Lifecycle: "Automatic_Group_Lifecycle.md"
    - Payment modules: "Payment_modules.md"
      - PayPal Configuration: "PayPal_Configuration.md"
    - Reports: "Reports.md"
    - e-Assessment Administration: "e-Assessment_Administration.md"
      - eAssessment ePortfolio: "eAssessment_ePortfolio.md"
      - eAssessment Question bank: "eAssessment_Question_bank.md"
    - Externe Werkzeuge : "External_Tools_-_Administration.md"
      - BigBlueButton module: "BigBlueButton_module.md"
      - Analytics module: "Analytics_module.md"
    - Customizing: "Customizing.md"

  - User management: "User_management.md"
    - Create User: "Create_User.md"
    - Assign roles: "Assign_roles.md"
    - Configure User: "Configure_User.md"
    - Data protection: "Data_protection.md"
  